#
# Sample maze file (size = 161x91)
#
# Each char defines one grid cell for the maze
# where 'A' means wall and 'B' means corridor
#

AAAAAAAAAAAAAAAAAAAAAAAAAAAAAAAAAAAAAAAAAAAAAAAAAAAAAAAAAAAAAAAAAAAAAAAAAAAAAAAAAAAAAAAAAAAAAAAAAAAAAAAAAAAAAAAAAAAAAAAAAAAAAAAAAAAAAAAAAAAAAAAAAAAAAAAAAAAAAAAAA
BBBBABBBBBABABABBBBBABBBBBBBBBBBABABBBABABBBABBBABBBBBBBABABBBBBBBABBBBBABBBABBBBBABABBBABBBBBABBBBBABBBBBBBABBBBBABBBABABBBABBBABABABBBBBABABBBABBBABBBBBBBABBBA
AAABAAABAAABABAAAAABAAABAAAAABAAABABAAABAAABAAABABAAAAABABAAABAAABABAAABABAAABAAAAABAAABAAAAABAAABAAAAAAABAAAAABAAABAAABABAAAAABABABABAAAAABABAAABABAAABABAAABAAA
ABABABABBBABBBABABBBBBABABBBABABABABABBBBBBBBBABBBABABABABBBBBBBABABBBABBBABBBBBABBBABBBBBABBBABABBBABABBBBBBBABBBBBABABABBBABBBBBABABBBBBABBBBBABABBBABABBBBBABA
ABABABABABABABABAAABABABABAAABABABABAAAAABAAAAABAAABABABAAAAABABAAAAAAAAABAAABAAABAAABAAAAABAAABABAAABAAABAAAAABABABABABAAABAAABAAABAAABAAABAAABABABABAAAAABABABA
ABABABBBABABABABBBABABBBABBBBBBBBBABBBBBABBBABBBABABBBBBABBBBBABABBBABBBABABABBBABBBABBBABBBBBBBABBBBBBBBBBBABBBABABBBBBABBBBBBBBBBBBBABABBBBBABBBABABBBBBBBABABA
ABABAAABAAABAAABABAAAAAAABAAAAAAABABABAAABAAABAAABAAABABABAAAAABABAAAAABABABAAABAAABAAABABAAAAABABAAAAAAAAAAABAAAAABAAAAABAAAAABAAAAAAABABAAABABAAABAAABABABABABA
ABBBBBABBBBBABABABABABABBBBBABBBBBABABABBBBBBBABBBABABABABABBBBBBBABABBBBBBBBBBBBBABBBABBBABBBBBABBBBBBBBBBBABABBBBBABBBBBABABABABABBBBBABABABABABABABABABABABBBA
AAAAABABAAAAABABAAABABAAABABAAAAAAABAAAAABAAAAAAABABAAABAAABABAAAAABAAAAABAAABABAAABABABAAABAAABABAAABABAAAAAAABAAABABAAABABABAAABAAAAABAAABABAAABABABAAAAABAAAAA
ABBBABABBBABBBBBBBBBBBABBBABABBBBBABBBABBBABABBBBBBBBBABBBABABBBBBBBABBBABABABABBBABABABBBABBBABABBBABABBBABBBABABBBBBBBABBBABABABBBBBBBBBABBBBBABBBBBBBBBABBBABA
ABABABABAAABAAAAAAABABAAAAABAAABAAABAAAAABABAAABAAABAAAAABAAABAAABAAAAABABABAAABABABAAAAAAABAAAAABAAAAAAAAABABAAAAABAAAAABAAABABAAABAAAAAAAAAAABABABAAAAAAABAAABA
ABABBBBBBBBBABBBBBABABBBABBBABBBABABBBABBBBBABABABABBBABBBABABBBABBBBBBBABBBABABABBBABBBBBABABABBBBBBBBBABBBABABBBBBABABABBBBBBBABABBBBBABABABBBABABBBBBABABABBBA
ABAAAAAAAAAAABABABABAAAAABABABABABABABAAAAABABAAABAAABAAAAABABAAABAAAAABABAAABAAAAABABAAABABABABAAABABAAAAABAAAAAAABABABAAAAABAAABAAAAABABABAAAAAAABAAAAABAAABABA
ABABBBABBBBBBBABABBBABBBBBABABABBBBBABABBBABBBABABBBBBABBBBBBBBBABBBABABABBBBBBBABBBBBABABABBBABBBABABBBABBBBBABBBBBBBABBBBBABBBBBABBBBBBBABABABBBABBBBBBBABABABA
ABAAABABAAAAAAAAABABAAAAABAAABABAAAAABAAABAAABABABABABAAABAAABAAAAAAABAAAAAAABAAAAAAABABAAABABAAAAAAAAABABABAAABAAAAABAAABAAAAABABABAAABABABABABAAAAAAAAABABABABA
ABABBBBBBBBBABBBBBABBBABBBABBBABABBBBBABBBABBBBBBBABABABABABABABABABBBABBBBBBBBBABBBBBABABBBABABBBBBABABABABBBABBBABABABBBABBBABABBBBBABABABBBBBBBABBBBBBBBBABABA
AAABAAABAAAAAAABAAAAABAAABABABAAAAABAAABABABAAAAAAAAABABABABABABABABAAAAABAAABABAAABAAABABAAABAAABAAABABABAAAAAAAAABABAAABABAAAAABAAAAAAABAAABABABABAAABABAAABAAA
ABABABABABABBBABABBBABABABBBABBBBBABABABABBBBBBBABBBBBABABBBABBBBBABABABBBBBABABABBBABABBBABBBABABBBABABBBABABBBABBBBBBBBBBBABBBABBBABBBABBBBBABABBBABABABBBABBBA
ABABABABABAAABAAAAABABABAAAAABAAAAABABABABABAAAAAAABAAABAAABABAAABABABABAAAAAAABABABABABABABAAABABABABABABABAAABABAAAAAAAAAAABAAABAAAAABABABABABAAAAABAAABAAABAAA
ABABABBBABABABABBBBBBBBBABBBBBBBABABBBBBABABBBABBBABBBABBBBBABABABBBBBBBABABBBABABABABABABABABBBBBABABBBABBBBBBBBBBBABBBBBABBBBBBBABABBBABABABABABBBBBBBBBBBBBBBA
ABABABAAABABABAAAAAAABAAAAABAAABABAAAAAAAAAAAAABAAAAAAABAAABABABAAABAAAAABABAAAAABAAABAAAAABABAAAAAAAAAAABABAAAAABAAAAABABAAAAABABABABAAABAAAAAAABAAAAAAAAAAAAABA
ABBBABBBBBABBBBBABBBABABBBBBBBABBBABABABABBBABABBBBBBBABABBBABABBBABBBBBABBBABBBABBBABBBBBBBABBBABABABABBBABABABBBBBABABABABABABABABBBBBABABBBBBABBBBBABBBBBABBBA
AAAAAAABAAABAAABAAABABABAAABAAAAAAABABABABAAABAAABABAAABABAAABABAAABABAAAAABABAAAAAAAAABAAABAAABABABABAAABABABAAAAABABABAAABABAAAAABABAAABAAABABAAABABAAABABABAAA
ABBBBBBBABBBABBBBBABBBABBBABABABABABBBABABABABBBBBABBBABABABBBBBABBBABBBBBABBBABBBABABBBABBBABABABBBBBABBBABABBBBBBBABBBABBBBBABBBABABABBBBBBBABBBABABBBBBABABBBA
ABAAABAAAAABABABAAAAABAAAAABABABABAAABABABABABAAABABAAAAABAAAAABAAAAABAAABABAAABAAABABABABABABABABABABAAABAAAAAAAAAAAAABAAABABABAAABAAAAABAAAAABABAAAAAAAAAAAAABA
ABABABBBABABABABABABABBBBBBBABABBBBBBBBBABBBABABBBABBBABBBABBBBBBBABBBBBABBBABBBBBBBABABABABBBABBBABABABABBBABABBBBBABBBABBBABABBBBBABBBABBBABABABABBBBBABBBBBABA
AAABAAABABABAAAAABABABAAABAAABABAAABABABABAAABABAAAAABABAAABAAAAAAAAABABABAAAAABABAAABAAABABAAABABAAAAABAAABABABABAAABAAAAABAAAAABABAAABAAABABABAAAAAAABABAAABABA
ABABBBBBABBBBBABBBBBBBABBBBBABBBABBBABABBBABABABABBBBBBBBBABBBBBABABBBABABBBABABABBBBBABABABABBBABABABABBBABABBBABABBBBBBBBBABBBBBABBBABABABABBBBBBBBBBBABABBBABA
ABAAABAAABABAAAAABAAABAAABAAABAAABABAAAAAAABAAAAAAABAAABAAAAABAAABAAAAABABAAABABAAAAAAABAAABAAABAAABABAAABABABAAAAAAABAAAAABABAAAAABABABABAAAAABABAAABAAABABAAAAA
ABABABBBABABBBBBABABABABABBBBBBBABABBBABABBBABBBBBABABABABBBBBABBBABABBBABBBBBABBBABBBBBBBABBBABBBABBBBBBBABABBBBBBBBBBBBBABABBBBBABABABBBABBBBBABABABBBABABBBBBA
ABABAAAAAAABABABABABABABAAAAABABABABAAABAAABABABAAABABABAAAAABAAABABABAAABAAABAAABAAABAAABABAAABAAABAAABABAAABABABABAAAAABABABAAAAAAABAAABABABAAAAABAAAAAAAAABAAA
ABBBABBBBBBBABABBBABBBBBABBBABABABABABABBBBBBBABBBBBABBBBBABBBABABBBABABBBBBABABABABBBBBABABBBABBBBBABBBABABABABABABABBBBBABBBBBABBBBBABABBBABABABBBBBABBBBBBBBBA
AAABABABAAAAABAAAAABAAAAABAAAAAAAAAAABABABAAAAABAAABAAABAAABAAABABAAAAAAABAAAAABABAAABAAABABAAAAABAAAAAAAAABABAAAAABAAAAABABABAAAAABAAABAAABABABAAAAABABABAAABABA
ABBBBBABBBABABABBBBBABBBBBBBABABBBABBBBBABBBABABBBABABABBBABBBBBBBBBABBBABABBBBBABABBBABBBBBBBABBBBBABBBABABABBBABABABABBBABABBBABABBBBBBBBBABBBBBBBABBBABABBBABA
AAAAAAAAABABABAAAAABABAAAAAAABAAABABAAAAABABABAAAAAAABAAAAAAAAABABAAABAAAAAAAAABABAAAAAAABAAAAABAAABABABABABABABABAAABAAAAAAABABABAAABAAABAAABAAABAAABAAAAABAAAAA
ABABBBABBBABABABBBBBBBBBBBABBBBBBBABABBBABABABABABABABABABBBABABABBBABBBBBABABABBBBBABABBBBBBBABBBABBBABBBABBBABBBBBBBABABBBBBABBBBBABABBBABABBBABBBBBBBBBABBBBBA
ABABAAABABABAAABAAABABAAAAAAABABAAAAABAAABAAABABABABABABAAABABAAABAAABAAAAABABAAAAABABABAAAAABABAAAAABABABAAAAABABABAAABAAAAAAAAAAAAABABAAABAAABABABAAAAABAAAAABA
ABABABBBABABBBABABABABABBBBBABABBBBBBBABBBABABABABBBBBBBABBBABBBABABABBBABBBABBBABBBABBBBBABBBABBBABBBABABABBBBBABABBBBBBBBBABABBBBBBBABBBABABABABABBBABBBBBABBBA
ABABAAABAAABAAAAABABABAAAAABAAABABAAAAABABABABABABABAAABABABABABABABABAAAAABABABABAAAAAAABAAAAAAAAABAAAAABAAABAAAAABAAAAAAABABABAAAAABAAAAABABAAAAAAAAAAABABAAAAA
ABBBBBBBABABABABBBABABABBBABBBBBABBBBBBBABBBABBBBBABABBBABABBBABBBABBBBBBBABBBABABABBBBBBBBBABBBBBABABBBABBBABABBBBBBBABABABABBBABBBBBABBBABBBABBBBBABBBBBABABABA
AAABABABABABABABAAABABAAABABABAAAAABAAABABABABAAAAABABAAAAAAABAAABABABABABABAAAAAAAAABAAAAABAAAAABABAAABABAAAAABABABAAABABAAABABABAAABABAAABAAAAABAAAAAAAAAAABABA
ABABABABBBBBBBABBBABABABBBABABABBBBBBBABABABBBABABABABBBABABBBBBABABABABABBBBBBBABABBBBBBBABABBBABBBABBBABABBBBBABABABBBABBBABABABABABBBABBBBBABBBABABBBBBABABBBA
ABAAABAAABABAAABAAABABABABABABABAAAAAAAAABABABABABAAAAAAABAAAAABAAABAAAAABAAABABABAAABABABABABABABABAAABAAAAABABAAABAAABABAAAAABAAABABABABAAAAAAABABAAABAAABABABA
ABBBBBABBBABABBBABABABABABBBABABBBBBABBBABABABABBBBBABBBABBBBBBBBBBBABBBBBBBABABBBBBABABABABBBABBBABABBBABBBBBABABABBBABBBABBBBBABBBBBABBBABABBBBBABBBBBABABBBABA
ABAAABAAAAAAAAABABABAAABAAAAAAAAABAAABABABAAAAAAAAABAAABABABAAAAAAAAAAAAAAABAAAAAAAAABAAAAAAABAAABAAAAABABAAAAAAABABAAABAAAAAAABAAAAABABABABABABABABABAAABABAAAAA
ABABBBBBABBBBBBBBBBBABBBABABBBBBABABBBABBBBBABABABBBBBBBBBABBBABABBBABBBBBABABABBBBBABABBBBBBBABBBBBABBBBBBBABABABABABBBBBBBABBBABBBABABABBBBBABABABABABBBBBBBBBA
AAAAAAAAAAAAABABAAABAAABABABAAABAAAAABAAAAAAABABAAABAAAAAAABAAABABABABABABABABAAABAAAAAAABAAAAAAABABABABAAAAABABABAAABAAABABAAAAABABAAAAABAAABAAABABAAABAAABAAAAA
ABBBABBBBBABBBABBBABBBBBBBBBABBBABBBBBBBABBBBBBBABBBABBBABABBBABBBABABABABABABBBBBBBABBBABABBBABABABBBABBBABABBBABBBBBABABABBBABBBABABBBABABABBBABBBABBBBBABABBBA
ABAAAAAAABAAAAAAAAAAABABAAAAABABAAAAABAAAAABAAABAAABABAAABAAAAAAABAAAAABAAABAAABAAAAAAABAAABAAABABAAAAABABABABAAABAAAAABAAABABABABAAAAABABABABAAAAABABAAAAAAAAABA
ABBBBBABBBBBBBABBBBBBBABBBABBBABBBABBBBBABBBBBABABBBABABABABBBABBBABBBBBBBABABBBBBBBBBABBBBBBBABBBABBBBBABABBBBBABBBBBBBABBBABBBABBBABBBBBABBBBBBBABABBBABABBBABA
AAABAAABAAAAABAAAAAAABAAABAAABAAAAAAAAABAAABAAABAAABABABABABAAAAABABAAABABAAAAABABAAAAABABAAAAABAAAAAAAAAAAAAAABABAAABAAAAAAAAAAAAABAAAAABAAABAAABAAABAAABABABABA
ABBBBBABABBBBBBBBBABABBBABABBBBBBBBBABBBABBBABBBABBBBBABBBABBBBBABBBBBABABBBBBBBABBBBBABABABABBBBBABBBBBBBBBABBBBBABBBABABABABBBABBBABBBABABABABBBBBBBBBBBABABBBA
ABABABAAAAABAAAAAAABABAAAAABAAAAAAABAAABABAAAAABAAABABABABABAAAAAAAAAAAAAAABAAAAABABAAABAAABABABAAABAAAAAAABABAAAAAAABABABABABABAAAAAAABAAABABAAABABABAAAAAAABAAA
ABABABBBBBBBBBBBABBBABABBBABBBABBBABABBBABBBABBBBBBBABABABABBBBBBBBBABBBBBBBBBABABABBBABABABBBABBBBBBBBBBBABBBBBABABBBABBBBBABABABBBABBBABBBABBBABABABBBBBABBBBBA
AAABAAAAAAABAAABABABABAAABAAABABAAAAABAAABAAABAAABAAABAAABABAAAAABAAAAABAAAAABABAAABABABABABAAAAAAABAAABAAAAAAAAABAAAAABAAAAAAABAAABABAAAAABABAAAAAAAAABAAAAABAAA
ABBBBBABBBBBBBABBBABBBBBBBABBBBBABABBBABABBBABBBABBBABBBABBBABBBABABBBABABBBBBBBABABABABBBBBBBBBABBBBBABBBABABBBABBBABBBBBBBBBBBABBBABBBBBBBBBABBBABBBBBABBBBBABA
AAAAABAAAAAAABABAAAAABAAABABAAAAABAAABABAAABAAAAABAAAAAAAAAAAAABABABAAABAAABAAAAABABAAABAAAAAAAAAAAAAAAAABABABAAABAAABABAAAAAAABABAAAAAAABAAAAABAAAAAAAAAAAAABABA
ABBBBBABABBBABABBBABABBBABABBBBBABBBABBBBBABBBBBABABABBBABABABABBBABBBABABBBBBABABBBABBBABABBBBBBBBBABBBABBBBBBBABABBBABABABBBABBBBBBBABBBABBBABBBBBBBBBBBABBBBBA
ABAAABABAAABAAABABABAAABAAAAABAAAAABAAAAABAAABAAABABAAABABABABAAABABAAAAABAAAAABAAABAAAAABAAAAAAABAAABAAABAAABAAABAAABABABABABAAABABABABAAABABABAAAAAAABAAABAAAAA
ABABBBBBBBABBBABABBBABBBABBBBBABABBBBBABABBBABABBBABBBBBABABBBABBBABABABBBBBABBBBBABBBABBBABBBBBBBBBBBBBBBABABABBBABABABABBBABBBBBABABBBABBBABBBBBABBBABBBABBBBBA
ABAAABAAAAAAABAAABAAABAAAAABAAABAAABAAABAAAAABAAAAAAAAABABABABABABABABABAAAAAAAAABAAAAABAAABAAAAABAAAAAAABABABABAAABAAAAABABAAABAAABAAAAAAABABAAABABABAAAAAAABAAA
ABBBABBBABBBABBBABBBABBBABABABBBABABBBABABABBBABBBBBBBBBBBBBABBBABBBABBBABBBBBBBABBBABBBABABBBABBBBBABBBBBBBABBBABBBABABABABABBBBBABABABBBABABBBABBBABBBBBBBBBBBA
AAAAAAABABAAAAABAAAAAAABABABABABABAAABABABAAAAAAAAAAAAAAABAAAAABAAAAABAAAAABAAABABABAAABABABABAAAAABAAABABAAABABABAAABABABAAAAABAAAAABABAAAAAAABAAABABAAAAAAAAABA
ABBBBBABBBBBBBBBBBBBBBABBBABBBABBBBBBBBBBBABABBBABBBBBABABABBBABABBBABBBABABABABBBABBBABBBBBABBBABBBABBBABABBBABABBBBBABBBBBABBBBBBBBBBBBBBBABBBBBABABBBABBBBBABA
ABAAAAABAAABABAAAAABAAAAAAAAABAAAAAAAAAAABABAAABABAAABABAAABAAABAAABABAAABABABABAAAAABAAAAABABAAABABAAAAAAABABAAABAAABABABAAAAABAAAAAAAAAAAAAAAAABAAAAABAAABABAAA
ABBBBBBBABABABBBBBABABBBBBABBBABABBBABABBBBBBBBBBBABBBABABBBABBBABBBBBABBBABABBBBBABBBBBABBBABABBBABBBABABABABABBBBBABABABABABBBBBBBBBBBBBBBBBBBBBBBABBBBBBBABBBA
ABAAABAAABAAAAABAAAAABAAAAABABABABAAABAAAAAAAAAAAAAAABABABAAAAABABAAAAABABAAABAAABAAAAABABAAABABABAAAAABABABABAAABAAABABAAABAAAAAAAAAAAAABAAABAAABABAAABABAAAAABA
ABBBABABBBABABABABBBBBBBBBABABABBBABABBBABABBBABBBABBBABBBBBBBABBBBBBBBBABBBBBABABABABABBBABBBABABBBABABBBABABABBBABBBABBBBBBBBBABBBBBBBABABBBABBBABABBBABBBBBABA
AAAAAAAAABABABABABABABAAAAABAAABAAABABAAABABABABAAABAAAAABABAAAAABAAAAABABAAAAABAAABABABABAAABAAABAAABAAABAAABAAAAABABABAAABAAAAABAAABABAAAAAAAAABABABAAABABAAABA
ABBBBBBBABABBBBBBBABABABABABBBBBBBBBBBBBABBBABBBBBABBBBBABABBBBBBBBBBBABABBBBBBBABBBBBABABBBABBBABABABABABBBBBABABBBABABABBBBBABABBBABABABABBBBBBBABABABBBABABABA
ABAAABABABAAABAAAAABAAABABAAABAAAAAAAAABAAAAAAABABAAAAAAABAAAAAAABAAABAAABAAABAAABABABAAAAABABABABABABABAAAAAAABAAABAAAAAAAAABABAAAAAAABABAAAAAAAAAAABAAABAAABAAA
ABABBBABBBBBBBBBABBBABBBABABBBABBBBBBBBBABBBABABABABABBBABABBBABBBABBBABBBBBABABBBABABBBABABABABABBBABBBABABBBABABBBBBABBBBBABBBBBABBBABABBBBBABBBBBBBABBBBBABBBA
ABAAAAAAAAAAABAAAAABABABABAAAAAAAAAAABAAABAAABAAABABAAABABAAABAAAAAAAAABAAAAAAABAAAAABAAABABAAAAABAAABABABABAAABABABABAAABAAAAAAABAAABABABABABAAAAABABAAABAAABAAA
ABABABBBABBBABABBBBBBBABABBBBBBBABBBABBBBBABBBBBABABBBABABBBABABBBBBBBABABBBBBABABBBABBBBBABBBBBABBBABABBBBBABBBBBABABBBBBABABBBBBBBABBBBBABABBBBBABABBBABBBBBBBA
AAABAAABABAAAAABAAAAAAAAABAAAAAAAAABABABABABAAAAABAAABABAAAAABAAABAAABAAAAABABAAABAAABABABABABABAAAAAAAAAAABABABABAAAAABABABABABAAAAABAAAAAAABABAAAAABAAABABAAAAA
ABABABABABBBBBBBABBBBBBBBBABBBABBBABBBABABBBBBBBBBBBBBBBBBABABABBBBBABBBBBBBABBBABBBABABABBBABABBBBBBBBBBBABBBABABBBABBBABBBBBABBBBBABBBABABBBABBBABABBBABABBBBBA
ABABABABAAABAAAAABABAAABAAABABAAABABABABAAABAAABABAAABABAAABABABAAABABAAABAAAAAAABABABAAAAABAAAAABAAABAAAAABABABABAAAAAAAAAAABABABABABAAABABAAABAAABABABAAAAABABA
ABBBBBABABBBBBBBABABABBBBBBBABBBBBABABABABBBABBBABABBBABABABABBBBBABABBBABBBBBBBBBABABBBABBBBBBBABBBABBBBBABABABABBBABBBBBBBABABABABBBABBBABABABABBBABABABBBBBABA
AAAAABABABABABABABAAAAABAAAAABAAAAAAABAAAAABABAAAAAAABABABABABABAAAAAAABAAAAABAAABABABAAAAABAAAAABABABAAAAAAAAABABABAAABABAAAAAAABAAAAAAABABABAAABAAAAAAABAAAAAAA
ABABBBBBBBABABABBBABBBBBABABBBBBABBBBBBBABBBABBBBBABBBABABBBBBABABBBBBBBABBBBBABABABABABABABBBBBABABABABABBBABABABABABBBABBBBBABBBABBBBBABBBBBBBABABBBBBBBBBBBABA
ABAAAAABAAAAABAAAAABABAAABAAAAABABAAABABAAAAABAAAAAAABAAAAAAAAABAAAAAAAAABABAAABAAABABABABAAABABAAABAAABABABABABAAABABABAAAAAAABABABAAAAAAAAAAAAABABAAABAAABAAABA
ABBBBBABBBBBABBBBBABABBBBBABBBBBABABBBABABBBABABABABBBABBBBBABBBABBBBBBBBBABBBABABBBABABBBABBBABABABBBBBBBABBBABABABABABABBBBBABABBBBBABABABBBBBBBBBABABABBBBBBBA
AAABAAABABAAAAAAAAABAAAAAAABAAABAAABAAAAAAABABABABAAABABAAAAAAAAAAABAAAAAAAAAAABABABABABABAAABAAABAAAAABABAAAAAAABAAABABABABABAAAAAAABABABAAABAAABAAABAAAAABABAAA
ABBBABABABBBABBBBBABBBABABABBBABABABABBBBBABBBABBBBBABBBBBBBBBBBBBBBABBBABBBBBABABABBBBBABABBBABABBBBBABABBBBBABBBABBBABBBABABABBBBBBBABBBABBBABBBABBBABBBABABBBA
ABAAABABAAAAABAAAAAAABABABABABABABAAABAAAAABAAABAAAAAAAAAAAAABAAABABABAAAAABABABABAAAAAAAAAAABABAAABABABAAABAAABAAAAAAABAAABABAAAAABABABAAAAAAABAAABAAAAABABAAABA
ABBBBBBBABBBABBBBBBBABABBBBBABABABABABABBBABBBABBBBBABABBBBBABBBABABBBABBBBBABBBABBBABBBBBABABBBBBBBABABBBABABBBBBABBBABABBBABBBABBBABBBBBBBABBBBBBBABBBABABBBABA
ABAAABABAAABABAAABAAABABABABAAABABABABAAABABABABAAAAABAAAAABABAAABAAABABABABAAAAABABAAABAAABAAABAAAAABAAABABABAAABABABABAAAAAAABABAAABAAABABABAAAAABAAABABABABAAA
ABBBABABABBBABABBBBBABABABABBBABBBABBBABBBBBABBBBBABBBABBBBBBBBBABBBABABABABABBBABABBBABBBBBBBBBABBBABABABABBBABABBBABABABBBBBABBBBBABABABABABBBBBABBBBBABABABBBA
ABAAAAABABAAABABABAAAAAAAAABAAABABAAABAAABAAAAAAAAAAABABABABABABABABAAABAAABABABAAABAAABABABAAAAABAAABABAAAAAAABABABAAAAABAAABABAAABAAABABAAAAABAAAAABABABAAAAABA
ABBBBBABBBBBBBABABBBABBBBBBBABBBABBBBBBBABABBBBBBBBBBBBBABABABABABABBBBBABBBBBABABBBABBBABABBBBBBBABBBABBBBBBBBBBBABBBABBBABBBBBABBBBBBBABABBBBBBBBBABABBBBBBBABB
AAAAAAAAAAAAAAAAAAAAAAAAAAAAAAAAAAAAAAAAAAAAAAAAAAAAAAAAAAAAAAAAAAAAAAAAAAAAAAAAAAAAAAAAAAAAAAAAAAAAAAAAAAAAAAAAAAAAAAAAAAAAAAAAAAAAAAAAAAAAAAAAAAAAAAAAAAAAAAAAA