#
# Sample maze file (size = 21x21)
#
# Each char defines one grid cell for the maze
# where 'A' means wall and 'B' means corridor
#

AAAAAAAAAAAAAAAAAAAAA
BBBBBBABBBABBBBBBBBBA
ABAAABAAABABAAAAAAAAA
ABBBABBBBBBBABBBBBBBA
ABAAAAAAAAAAABAAAAABA
ABBBBBBBBBBBABABBBABA
AAAAAAAAAAABABABABABA
ABBBBBBBBBABABABABABA
AAAAAAABABABABABABABA
ABBBBBBBABABBBABABABA
ABAAAAAAABAAAAABABABA
ABABABBBABBBBBABABBBA
ABABABABAAAAABABAAAAA
ABABABABBBBBABABBBBBA
ABABABAAAAABABABAAAAA
ABBBBBABBBBBABABBBBBA
AAAAAAAAABAAABAAAAABA
ABBBBBBBABABABBBBBBBA
ABAAAAABABABAAAAAAAAA
ABABBBBBBBBBBBBBBBBBB
AAAAAAAAAAAAAAAAAAAAA
